#####################################################################################################
S #   #         #         #   #       #                 # #             #         #         #       #
# # # # ### ### ##### # # # # # # ##### ######### ##### # # ####### ### # ##### ### # ####### ##### #
# # # #   # # #     # # # # #   #         #     #   # # #   #     # #   # #     #   # #       #   # #
# ### ### # # ##### ### ### ############### ### ### # # ##### ### # ### ### # ### ### # ####### # # #
#   #     # # #       #         #           #     # #       #   # #   # #   # #   # #   #   #   #   #
### # ##### # # ##### ########### # ############# # ####### ### # ### # # # ### ### ##### # # ##### #
#   # #   # #   #   #             # #           #   #   # #     #     #   # #   #       # #   #     #
# ### ### # ##### # ####### ######### ######### ##### # # # ############# ### ######### # ####### ###
#   #     #     # #   #   # #       # #   #   #       # #   #         #   #             # #     #   #
### ######### # # ### # # ### ##### # # # # # ######### # ### ####### ##### ########### # # ### ### #
#   #       # #     #   #     #     # # #   # #   #     #   # #     #       #         # #     #   # #
# ### ##### ####### ######### # ### # ####### # # # ######### # ############# ####### # ##### ### ###
#   #     #     #     #     # #   # #         # #   #   #   # #   #         #   #     # #   #   #   #
### ##### ##### ####### ### ##### ### ######### ### # # # # # ### # ####### ### # ##### # # ##### # #
# #   #   #             # #       #   #   #     #   # #   #       #     #       #   #   # # #   # # #
# ### # ################# # ####### ### # # ######### ##### ########### ########### # ### # # # ### #
#   # # #   #         #     #         # #   #   #     #   # #       #   #     #   # # #   # # #     #
# # # # # # # ####### ####### ######### ##### # # ##### # ### ##### # ### ### ### # # # ### # ##### #
# # # #   #   #     # #       #       #       #   #     #   #     # #       #   #   # # # # #     # #
# ### ##### ### ### # # ####### ##### ############# ####### ##### # ########### # ##### # # ### # ###
#   #     #   # # # #   #       #         #       #   #           # #     #     #     # #     # #   #
### ##### ### # # # ##### ######### ##### # ##### ### ############# # ### # ######### # ##### ##### #
#     # #   # # #   #     #       # #   # # #       #   #       #     # # # #   #   #   #   #       #
# ### # ### # # # ### ##### ##### ### # # # ####### ### # ##### ####### # # # ### # # ### # #########
#   #     # #   # #   #         #   # # # # #     #   #       #   #     # # #     #   #   #         #
### ####### ####### ### ########### # # # # # ### ### # ######### ##### # # ########### ########### #
#   #     #       #   # #           # # #   # #   #   #   #     #   #   # # #   #       #           #
# ### ### ####### ### # # ########### # # ### # ### ####### ### ### # ### # # # # ####### ###########
#       # #   #   #   # #             # # #   # # # #       #       #   #   # #   #     #           #
######### # # # ### ### ############### ### ### # # # ######### ####### # ### ##### ### ######### # #
#         # #   # #     #   #           #   #   # # # #       # #     #   #   #   # # #         # # #
# ######### ##### # ##### # # ########### ### ### # # # ##### # # ### ##### ### # # # ######### ### #
#         # #       #     #   #             #   # # # #   #   # # #   #     #   #   #               #
# ####### # ######### ##### ### ########### ### # # # ### # ##### # ### ##### # ################### #
# #     # #   #       # #   #   #   #     # #   #       # #     # #       #   # #       #   #   #   #
# # ### # ### # ####### # ### ### # # ### ### ### ####### ##### # ######### ### # ##### # # # # #####
# #   # # #   # #     #   #       # #   #     #   #       #   #   # #   #   #   #   # # # #   #     #
##### # # # ### # ### ##### ########### ########### ####### # ##### # # # ### ##### # # # ######### #
#     #   # #     #   #     #       #   #   #       #       #     #   # #   # #       # #   #       #
# ######### # ##### ### ##### ##### # ### # # ################# # ##### ### # # ####### ### # ##### #
#   #     # # #     #   #   #   #     #   # #                   #       #   # # #         # # #     #
# # # ### # ### ### # ##### ### ####### ### ### ####################### # ##### # ######### # ### ###
# # # #   # #   #   #     #   #           #     #     # #               # #   # #     #   # #   #   #
# # # # ### # ########### ### ########### ####### ### # # ############### # # # ##### # # # ### #####
# # # # #   # #               #     #   #   #   #   # # # #             #   #   #   #   #     #     #
# # # # # ### # ############# ##### # # ##### # ### # # # # ########### ####### # # ############### #
# #   # #   #     #     #       #   # #       #     # #   #           #       #   # #             # #
####### ### ### ### ### # ##### # # # ############### # ##### ####### ####### ####### ########### # #
#         #   # #   # # # #   #   # # #   #         # # #   # #     #   #   #         # #       #   #
# ########### ### ### # ### # ####### # ### # ####### ### # ### ### ### # # ########### # # ####### #
#                 #         #         #     #             #     #       # #               #         E
#####################################################################################################