#################################################
S #       #         #               #           #
# ##### # # ####### # # ########### # ###########
# #     #   #       # # #         #   #         #
# # ######### ####### # # ####### ### # ####### #
# #     #     #       #   #   #   #   #   #   # #
# ##### ####### ######### ### # ######### ### # #
#     # #       #       #     #     #     #   # #
##### # # ####### ##### ########### # ##### ### #
#   # #   # #   #   #   #       #   # #     #   #
# ### # ### # # # # ### # ##### # ### ##### # ###
#   # #     # # # #   # #   # # #           #   #
# # # ##### # # ##### # ### # # ######### ##### #
# # # # #   # # #     # #   # #       #   #   # #
### # # # ### # # ##### # ### ####### # ### # # #
#   # # #   # #   #   #   #     #     # #   # # #
# ### # ### # ####### ####### # # ##### # ### # #
# #   #     #       #   #     # # #     # # #   #
# # ############### # # # # ##### ####### # ### #
#                   # #   #               #     E
#################################################