#####################################################################################################
S             #         #       #     #       #                     #       #         #             #
############# # ### ##### ##### # # ### ### # ################# ### # # ##### # ####### ######### # #
#         #   #   #   #   #   #   #   #   # #     #       #   #   #   #   #   #         #         # #
### ####### ##### ### # ### # ### ### ### # ##### # ##### # # ########### # ####### ##### ###########
#   #     # #     #   # #   #   # #   #   #     # # #       #             #   #   #   # #           #
# ### ### # ####### # # # ##### # # ### ####### # # ####### ################# # # ### # ######### # #
#   #   # #   #     # # #     # # #       #     # # #   #   #         #       # #   #   #       # # #
### # ### ### # ####### ##### # ########### ##### # # # ##### ####### # ####### ### ##### ##### ### #
#   # #   #   # #       #     #       #     #   #   # # #     # #     #   # #   #         #     #   #
# ### # # # ### # ####### ########### # ##### # ##### # # ##### # ####### # # ############# ##### ###
# #   # # # #   #     #   #   #     # #       #       #         #           #           # #   #     #
# # ### ### # ####### # ### # # ##### ##################### ######### ################# # ### ##### #
#     #   # #       # # #   #   #     #                 #   #       # #                 #   #       #
######### # ### ##### # # # ### # ##### # ############# ### # ##### ### ################# ### #######
#       # #   # #     # # # #   # #     # #       #   #   # # #   #     #     #               #     #
# ##### # ### # # ##### ### ##### ##### ### ##### # ##### ### # # ####### ### ################# ### #
#   #       # #       #   #       #   #     #     #           # #           #           #     # # # #
### ######### ########### ####### # # ####### ### ########### # ############### ##### # # ### # # # #
#   #       # #         #       #   #         #   #         # #   # #         # #   # # # #   #   # #
# ### ##### # # ####### ####### # ################# ####### ##### # # ####### ### # ### # # ### ### #
# #   #     # #   # #   #       # #                   #     #   #   #     #       #   #   #     #   #
# # ### ##### ### # # ### ##### ### ################### ##### # ### ##### ########### ########### ###
#   #   #     #   #     #     # #   #                 #       # #       # #       #         #   #   #
# ### ### ##### ####### ##### ### ### ############### ######### # ####### # ##### ######### # # ### #
# # #   #     #       #       #     #     # #     #   #       # # # #   # # #   # #   #   #   #     #
# # ### ##### ##### # ######### ######### # # # ### ### ##### # # # # # # # ### # # # # # ######### #
#   #   #   #     # #   #       #         #   #         #   # #     # # #       # # #   # #   #     #
# ### # # # ##### # ### # ####### # ##### ####### ####### ### ####### # ####### # # ##### # # # #####
# #   # # #   #   #   #   #     # # #   # #     # #   #   #   #       #       # #     #   # #   #   #
# # ##### ### # ### ##### # ### # ### # ### ### ### # ### # ### ############# ######### ######### # #
# #   #   #   #   # #   # # #     #   # #   #   #   #   # # #   #   #       #       #   #         # #
# ### # ### # ### ### # ### ####### ### # ### ### ##### # # ### # # # # ########### # ### ######### #
# # #   #   # #   #   #   #     #     # #   #       #   # #     # # # #   #     #     #   #         #
# # ##### ##### ### ##### ##### # ##### ### ######### ### # ##### # ##### # ### # ##### ### ####### #
# #     #   #   #   #         # # #     # #   #   #   #     #     #     #     #   #   # #   #   #   #
# ### ##### # ### ########### # # # ### # ### # # # ######### ######### ########### # # # ### # # ###
#     #     # # #       #     #   #   #     # # # #     #       #     #             #   #     # #   #
####### ##### # # ##### ### ### ##### # ##### ### ##### # ####### ### ####### ################# #####
#       #     # # #   #   # #   #     # #         #     # #   #   # #       #     #       #   #     #
# ####### ##### # ### ### # ##### ####### ######### ##### # ### ### ####### ##### # ##### # # ##### #
#     #   #     #       # # #   #         #   #   # #   #   #   #         #     # #   #     # #     #
# ### # ####### # ####### # # # ### ####### # # # # # # # ### ####### ######### ##### ####### # #####
#   # #       #   #       #   #   # #       #   # #   #   #   #       #       #   #   #   #   #     #
##### ####### # ### ############# ### ########### ##### ### ### ##### # ##### ### # ### # ### ##### #
#         #   # #   #           #   #   #       #     # #   # #   #   # #       # #     #   #       #
# ######### ##### ### ############# ### # ########### ### ### # # ##### # ####### ######### ####### #
#                 #                     #                 #     #       #                   #       E
#####################################################################################################