#################################################################################
S #       #                           #       #     #     #       #       #     #
# ##### # ### ##### ################# # ##### # ### # # ### ### # ### ### ##### #
#       #   #   #   #       #       #   #   # #   #   #     #   #   # #         #
########### ##### ### ##### # ##### ##### # # ### ########### ##### # ###########
#       #   #     #   #     # #   #       # #   #   #       #   #   # #         #
# ##### # ### ##### ### ### # ### ######### ### ### # ##### ### # ### # ##### # #
#     # #   #       #   #   #           #   # # # # #     #     #   #   #   # # #
# ### ##### ######### ############### ### ### # # # ##### ######### ##### # ### #
# #   #   #         #     #       #   #   #       #   #   #   #   # #   # # #   #
# # ### # ######### # ### # ### ### ### ########### ### ### # # # # # # # # # # #
# # #   # #       # #   #     #   #   #   #   #     #   #   #   # # # #   #   # #
# # # ### # ##### # ### ######### ### ### # # # ##### ### ####### # # ######### #
# # #   #   #     # # # #       # #     # # #   #     #   #       #   #       # #
# # ### ##### ##### # # # ##### # # ##### # ##### ##### ### ########### ##### # #
# #   # #   #   #   #   #     # #   #   #       #     #   #               #   # #
##### # ### ### # ### ####### # ##### # # ######### # ### ################# #####
#     #   # #   # # # #     # #       # #   #     # #   #   # #           # #   #
# ####### # # ### # # # ##### ######### ### # ### # # # ### # # ### ##### # # # #
#   #     # #   # #     #     #       # #   # #   # # # #     # #   #   # #   # #
### # ##### ### # ##### # ########### # ##### # ##### # # ##### ##### # # ##### #
#   # #     #   #     # #       #     #       # #     # #   #   #   # # #     # #
# ### ##### # ####### # ##### # # ############# # ####### ### ### # # # ##### # #
#           #       # # #   # # #     #         # #       #   #   # # #     #   #
# ############# # ### ### # ### ##### # ######### # ####### ### ### # ##### #####
#   #           # #   #   #     #   # #     #   #   # #   #     #   # #   #     #
##### ##### ####### ### ######### # # ##### # # # ### # # # ##### ### # # ##### #
#     #   # #     # #   # #       #       # # #       # # #     #     # #       #
# ##### # ### ### # # ### # # ############# ########### # ############# ####### #
#       #       #     #     #                           #               #       E
#################################################################################